Animation	KEYWORD1
Boom	KEYWORD1
Button	KEYWORD1
Cylon	KEYWORD1
Disco	KEYWORD1
Meter	KEYWORD1
ModeIndicator	KEYWORD1
Motion	KEYWORD1
MotionSample	KEYWORD1
MultiBoom	KEYWORD1
NeoPixelParallel	KEYWORD1
Particle	KEYWORD1
Rain	KEYWORD1
Sines	KEYWORD1
TopLight	KEYWORD1
Walker	KEYWORD1
Wheel	KEYWORD2
Color	KEYWORD2
lerp	KEYWORD2
getR	KEYWORD2
getG	KEYWORD2
getB	KEYWORD2
brightness	KEYWORD2
